基準日,基準価額（円）,前日比,純資産総額,直近決算日,直近分配金,分配金再投資基準価額
20180131,10000,0,500000000,0,0,10000
20180201,10007,7,500339146,0,0,10007
20180202,9921,-86,496032935,0,0,9921
20180205,9752,-169,487610075,0,0,9752
20180206,9263,-489,463174282,0,0,9263
20180207,9553,290,477650053,0,0,9553
20180208,9519,-34,475941720,0,0,9519
20180209,9185,-334,459248422,0,0,9185
20180213,9470,285,473495534,0,0,9470
20180214,9562,92,478080987,0,0,9562
20180215,9714,152,485713295,0,0,9714
20180216,9871,157,493545242,0,0,9871
20180219,9784,-87,489218438,0,0,9784
20180220,9830,46,491505861,0,0,9830
20180221,9942,112,497089937,0,0,9942
20180222,9969,27,498448576,0,0,9969
20180223,9915,-54,495790756,0,0,9915
20180226,10081,166,505519412,0,0,10081
20180227,10191,110,593554089,0,0,10191
20180228,10083,-108,616446012,0,0,10083
20180301,9975,-108,633867756,0,0,9975
20180302,9775,-200,652203817,0,0,9775
20180305,9824,49,662278617,0,0,9824
20180306,10064,240,679678278,0,0,10064
20180307,10107,43,686965579,0,0,10107
20180308,10223,116,695897036,0,0,10223
20180309,10234,11,699153081,0,0,10234
20180312,10464,230,718681196,0,0,10464
20180313,10474,10,727839406,0,0,10474
20180314,10322,-152,771125739,0,0,10322
20180315,10359,37,792831698,0,0,10359
20180316,10390,31,815704053,0,0,10390
20180319,10316,-74,815136718,0,0,10316
20180320,10042,-274,801141249,0,0,10042
20180322,9950,-92,799362019,0,0,9950
20180323,9554,-396,770421764,0,0,9554
20180326,9327,-227,742185760,0,0,9327
20180327,9706,379,712650170,0,0,9706
20180328,9166,-540,672777268,0,0,9166
20180329,9072,-94,667327739,0,0,9072
20180330,9241,169,679908700,0,0,9241
20180402,9246,5,740809789,0,0,9246
20180403,8903,-343,713376524,0,0,8903
20180404,9043,140,729526618,0,0,9043
20180405,9211,168,745753529,0,0,9211
20180406,9377,166,760801006,0,0,9377
20180409,9124,-253,741292383,0,0,9124
20180410,9144,20,745113494,0,0,9144
20180411,9499,355,777691959,0,0,9499
20180412,9446,-53,774782235,0,0,9446
20180413,9544,98,784862949,0,0,9544
20180416,9522,-22,784670255,0,0,9522
20180417,9485,-37,732981113,0,0,9485
20180418,9844,359,751489224,0,0,9844
20180419,9895,51,755882986,0,0,9895
20180420,9878,-17,754844628,0,0,9878
20180423,9759,-119,752205854,0,0,9759
20180424,9715,-44,751824742,0,0,9715
20180425,9505,-210,736122221,0,0,9505
20180426,9493,-12,732334893,0,0,9493
20180427,9773,280,753276292,0,0,9773
20180501,9862,89,759571492,0,0,9862
20180502,10019,157,772398269,0,0,10019
20180507,10163,144,784047562,0,0,10163
20180508,10333,170,807605086,0,0,10333
20180509,10436,103,818007627,0,0,10436
20180510,10624,188,840047024,0,0,10624
20180511,10683,59,851357298,0,0,10683
20180514,10611,-72,851462837,0,0,10611
20180515,10678,67,869693504,0,0,10678
20180516,10572,-106,872447979,0,0,10572
20180517,10656,84,888687029,0,0,10656
20180518,10661,5,887669525,0,0,10661
20180521,10501,-160,874241422,0,0,10501
20180522,10566,65,883130690,0,0,10566
20180523,10469,-97,874005871,0,0,10469
20180524,10504,35,876599132,0,0,10504
20180525,10504,0,874615185,0,0,10504
20180528,10541,37,877536060,0,0,10541
20180529,10514,-27,874654095,0,0,10514
20180530,10426,-88,867332975,0,0,10426
20180531,10543,117,864840869,0,0,10543
20180601,10591,48,866476453,0,0,10591
20180604,10922,331,894224966,0,0,10922
20180605,11149,227,903121034,0,0,11149
20180606,11210,61,926647886,0,0,11210
20180607,11354,144,945822498,0,0,11354
20180608,11215,-139,946333618,0,0,11215
20180611,11198,-17,957106546,0,0,11198
20180612,11382,184,974214994,0,0,11382
20180613,11533,151,989098036,0,0,11533
20180614,11574,41,1057007238,0,0,11574
20180615,11852,278,1089260707,0,0,11852
20180618,11776,-76,1101987099,0,0,11776
20180619,11791,15,1129052710,0,0,11791
20180620,11664,-127,1155924563,0,0,11664
20180621,11860,196,1137747656,0,0,11860
20180622,11655,-205,1160123106,0,0,11655
20180625,11539,-116,1192806874,0,0,11539
20180626,11162,-377,1178614406,0,0,11162
20180627,11326,164,1208013830,0,0,11326
20180628,11143,-183,1168722463,0,0,11143
20180629,11337,194,1185967647,0,0,11337
20180702,11278,-59,1173782324,0,0,11278
20180703,11404,126,1208767222,0,0,11404
20180704,11102,-302,1197740852,0,0,11102
20180705,11108,6,1196286390,0,0,11108
20180706,11288,180,1215681334,0,0,11288
20180709,11480,192,1252991468,0,0,11480
20180710,11651,171,1284089179,0,0,11651
20180711,11638,-13,1315649722,0,0,11638
20180712,11705,67,1332408369,0,0,11705
20180713,11963,258,1376398825,0,0,11963
20180717,11823,-140,1368594868,0,0,11823
20180718,11976,153,1420429718,0,0,11976
20180719,11870,-106,1439838058,0,0,11870
20180720,11729,-141,1445820446,0,0,11729
20180723,11517,-212,1449213795,0,0,11517
20180724,11523,6,1454891063,0,0,11523
20180725,11549,26,1466492911,0,0,11549
20180726,11759,210,1482395166,0,0,11759
20180727,11461,-298,1445984504,0,0,11461
20180730,11059,-402,1405364311,0,0,11059
20180731,10738,-321,1373668783,0,0,10738
20180801,10871,133,1379561486,0,0,10871
20180802,10870,-1,1372524044,0,0,10870
20180803,11195,325,1476425568,0,0,11195
20180806,11128,-67,1467303538,0,0,11128
20180807,11220,92,1483357883,0,0,11220
20180808,11351,131,1507708346,0,0,11351
20180809,11236,-115,1501641597,0,0,11236
20180810,11176,-60,1502143703,0,0,11176
20180813,11107,-69,1512111339,0,0,11107
20180814,11129,22,1515893668,0,0,11129
20180815,11188,59,1522166459,0,0,11188
20180816,10929,-259,1486342768,0,0,10929
20180817,10951,22,1473141965,0,0,10951
20180820,10783,-168,1451183638,0,0,10783
20180821,10776,-7,1453429992,0,0,10776
20180822,10936,160,1468834498,0,0,10936
20180823,11082,146,1482040789,0,0,11082
20180824,11102,20,1496018492,0,0,11102
20180827,11239,137,1517669828,0,0,11239
20180828,11424,185,1557499306,0,0,11424
20180829,11364,-60,1553037559,0,0,11364
20180830,11494,130,1571512612,0,0,11494
20180831,11416,-78,1569574251,0,0,11416
20180903,11394,-22,1557124999,0,0,11394
20180904,11404,10,1558600424,0,0,11404
20180905,11329,-75,1548365687,0,0,11329
20180906,10991,-338,1503080024,0,0,10991
20180907,10737,-254,1471080239,0,0,10737
20180910,10713,-24,1468329745,0,0,10713
20180911,10782,69,1480551581,0,0,10782
20180912,10908,126,1500990656,0,0,10908
20180913,10899,-9,1487610151,0,0,10899
20180914,11067,168,1512541620,0,0,11067
20180918,10777,-290,1475177750,0,0,10777
20180919,10853,76,1486692789,0,0,10853
20180920,11008,155,1487858773,0,0,11008
20180921,11102,94,1494795337,0,0,11102
20180925,11064,-38,1486911681,0,0,11064
20180926,11136,72,1506926100,0,0,11136
20180927,11200,64,1512209569,0,0,11200
20180928,11373,173,1542171195,0,0,11373
20181001,11197,-176,1522648937,0,0,11197
20181002,11397,200,1555714402,0,0,11397
20181003,11210,-187,1510075493,0,0,11210
20181004,11330,120,1526268140,0,0,11330
20181005,10974,-356,1482309423,0,0,10974
20181009,10515,-459,1426187888,0,0,10515
20181010,10589,74,1425398245,0,0,10589
20181011,9934,-655,1336187584,0,0,9934
20181012,9876,-58,1328656737,0,0,9876
20181015,10199,323,1380311091,0,0,10199
20181016,10049,-150,1373061310,0,0,10049
20181017,10460,411,1437846291,0,0,10460
20181018,10481,21,1443913200,0,0,10481
20181019,10141,-340,1401660191,0,0,10141
20181022,10054,-87,1389729428,0,0,10054
20181023,10186,132,1411163215,0,0,10186
20181024,10204,18,1419076033,0,0,10204
20181025,9616,-588,1333775567,0,0,9616
20181026,10210,594,1418241257,0,0,10210
20181029,9990,-220,1382397751,0,0,9990
20181030,9716,-274,1336395136,0,0,9716
20181031,9964,248,1392065716,0,0,9964
20181101,10278,314,1442519126,0,0,10278
20181102,10548,270,1482437337,0,0,10548
20181105,10383,-165,1460606924,0,0,10383
20181106,10244,-139,1413577323,0,0,10244
20181107,10302,58,1420454158,0,0,10302
20181108,10648,346,1467397603,0,0,10648
20181109,10505,-143,1448443862,0,0,10505
20181112,10311,-194,1438131436,0,0,10311
20181113,9865,-446,1377053587,0,0,9865
20181114,10008,143,1398772519,0,0,10008
20181115,9991,-17,1394785708,0,0,9991
20181116,10151,160,1410886715,0,0,10151
20181119,9884,-267,1374686674,0,0,9884
20181120,9457,-427,1315557943,0,0,9457
20181121,9329,-128,1300214674,0,0,9329
20181122,9392,63,1308216720,0,0,9392
20181126,9249,-143,1290452344,0,0,9249
20181127,9632,383,1343950476,0,0,9632
20181128,9636,4,1300955443,0,0,9636
20181129,9903,267,1338921486,0,0,9903
20181130,9777,-126,1322575200,0,0,9777
20181203,9935,158,1344199312,0,0,9935
20181204,10210,275,1380147374,0,0,10210
20181205,9757,-453,1327354235,0,0,9757
20181206,9762,5,1327679028,0,0,9762
20181207,9812,50,1334407031,0,0,9812
20181210,9526,-286,1291561707,0,0,9526
20181211,9694,168,1315633940,0,0,9694
20181212,9743,49,1317336265,0,0,9743
20181213,9888,145,1336708028,0,0,9888
20181214,9941,53,1343380763,0,0,9941
20181217,9727,-214,1313712449,0,0,9727
20181218,9320,-407,1258685309,0,0,9320
20181219,9341,21,1262553922,0,0,9341
20181220,9071,-270,1225138834,0,0,9071
20181221,8664,-407,1160050613,0,0,8664
20181225,8044,-620,1073923697,0,0,8044
20181226,8087,43,1061482537,0,0,8087
20181227,8694,607,1141138379,0,0,8694
20181228,8642,-52,1126967133,0,0,8642
20190104,8172,-470,1069212512,0,0,8172
20190107,8725,553,1144484953,0,0,8725
20190108,8994,269,1182105681,0,0,8994
20190109,9089,95,1196244631,0,0,9089
20190110,9155,66,1208598354,0,0,9155
20190111,9257,102,1228540560,0,0,9257
20190115,9162,-95,1214301273,0,0,9162
20190116,9414,252,1248021569,0,0,9414
20190117,9474,60,1257033327,0,0,9474
20190118,9571,97,1270012786,0,0,9571
20190121,9527,-44,1264698139,0,0,9527
20190122,9529,2,1265875612,0,0,9529
20190123,9191,-338,1221016057,0,0,9191
20190124,9127,-64,1213485821,0,0,9127
20190125,9277,150,1234541055,0,0,9277
20190128,9460,183,1259192392,0,0,9460
20190129,9250,-210,1231008454,0,0,9250
20190130,9077,-173,1210492527,20190130,0,9077
20190131,9408,331,1254593975,20190130,0,9408
20190201,9667,259,1289234985,20190130,0,9667
20190204,9652,-15,1288179495,20190130,0,9652
20190205,9865,213,1317600495,20190130,0,9865
20190206,9997,132,1336123459,20190130,0,9997
20190207,9944,-53,1329632889,20190130,0,9944
20190208,9635,-309,1289944664,20190130,0,9635
20190212,9649,14,1280312407,20190130,0,9649
20190213,9800,151,1300246830,20190130,0,9800
20190214,9849,49,1307288081,20190130,0,9849
20190215,9808,-41,1299607645,20190130,0,9808
20190218,9783,-25,1296046362,20190130,0,9783
20190219,9781,-2,1294289205,20190130,0,9781
20190220,9876,95,1306864094,20190130,0,9876
20190221,9857,-19,1294147344,20190130,0,9857
20190222,9761,-96,1281065256,20190130,0,9761
20190225,9888,127,1297210902,20190130,0,9888
20190226,9982,94,1309721088,20190130,0,9982
20190227,9896,-86,1297467365,20190130,0,9896
20190228,9933,37,1301779108,20190130,0,9933
20190301,9971,38,1307785782,20190130,0,9971
20190304,10012,41,1312535083,20190130,0,10012
20190305,10026,14,1314239331,20190130,0,10026
20190306,10071,45,1319744163,20190130,0,10071
20190307,10038,-33,1316301636,20190130,0,10038
20190308,9829,-209,1288724533,20190130,0,9829
20190311,9765,-64,1278815427,20190130,0,9765
20190312,10108,343,1315569320,20190130,0,10108
20190313,10110,2,1315716908,20190130,0,10110
20190314,10217,107,1330252870,20190130,0,10217
20190315,10220,3,1322457108,20190130,0,10220
20190318,10209,-11,1311127676,20190130,0,10209
20190319,10163,-46,1303122624,20190130,0,10163
20190320,10241,78,1311665765,20190130,0,10241
20190322,10467,226,1338771519,20190130,0,10467
20190325,10134,-333,1306516792,20190130,0,10134
20190326,10136,2,1307567532,20190130,0,10136
20190327,10202,66,1316863854,20190130,0,10202
20190328,10120,-82,1306680098,20190130,0,10120
20190329,10220,100,1322533438,20190130,0,10220
20190401,10306,86,1335129059,20190130,0,10306
20190402,10518,212,1362875851,20190130,0,10518
20190403,10592,74,1373393019,20190130,0,10592
20190404,10692,100,1383902669,20190130,0,10692
20190405,10692,0,1377449860,20190130,0,10692
20190408,10749,57,1376316628,20190130,0,10749
20190409,10781,32,1370123237,20190130,0,10781
20190410,10740,-41,1347186734,20190130,0,10740
20190411,10735,-5,1347819293,20190130,0,10735
20190412,10723,-12,1342112570,20190130,0,10723
20190415,10731,8,1341063217,20190130,0,10731
20190416,10648,-83,1329809618,20190130,0,10648
20190417,10765,117,1333389246,20190130,0,10765
20190418,10769,4,1331327583,20190130,0,10769
20190419,10781,12,1330694882,20190130,0,10781
20190422,10778,-3,1327489250,20190130,0,10778
20190423,10818,40,1332341794,20190130,0,10818
20190424,11134,316,1369047029,20190130,0,11134
20190425,11048,-86,1347514440,20190130,0,11048
20190426,10962,-86,1332222062,20190130,0,10962
20190507,10886,-76,1317526791,20190130,0,10886
20190508,10555,-331,1276535748,20190130,0,10555
20190509,10480,-75,1271989567,20190130,0,10480
20190510,10398,-82,1263795181,20190130,0,10398
20190513,10313,-85,1250155393,20190130,0,10313
20190514,9831,-482,1190765099,20190130,0,9831
20190515,9943,112,1205076451,20190130,0,9943
20190516,10093,150,1221879358,20190130,0,10093
20190517,10182,89,1235674007,20190130,0,10182
20190520,9838,-344,1188342049,20190130,0,9838
20190521,9573,-265,1156760391,20190130,0,9573
20190522,9722,149,1174499163,20190130,0,9722
20190523,9636,-86,1165621622,20190130,0,9636
20190524,9382,-254,1135979134,20190130,0,9382
20190527,9339,-43,1131029426,20190130,0,9339
20190528,9344,5,1135315544,20190130,0,9344
20190529,9320,-24,1132404798,20190130,0,9320
20190530,9242,-78,1125720127,20190130,0,9242
20190531,9220,-22,1124885562,20190130,0,9220
20190603,8948,-272,1092128215,20190130,0,8948
20190604,8599,-349,1049843279,20190130,0,8599
20190605,8952,353,1093464518,20190130,0,8952
20190606,8978,26,1100132803,20190130,0,8978
20190607,9073,95,1113528252,20190130,0,9073
20190610,9254,181,1135144291,20190130,0,9254
20190611,9374,120,1151316275,20190130,0,9374
20190612,9462,88,1166399144,20190130,0,9462
20190613,9338,-124,1155584106,20190130,0,9338
20190614,9357,19,1160668383,20190130,0,9357
20190617,9336,-21,1159818040,20190130,0,9336
20190618,9492,156,1179671249,20190130,0,9492
20190619,9640,148,1199011726,20190130,0,9640
20190620,9588,-52,1188210031,20190130,0,9588
20190621,9563,-25,1184024887,20190130,0,9563
20190624,9557,-6,1184293626,20190130,0,9557
20190625,9579,22,1183659427,20190130,0,9579
20190626,9392,-187,1160687865,20190130,0,9392
20190627,9547,155,1179806829,20190130,0,9547
20190628,9623,76,1183262582,20190130,0,9623
20190701,9681,58,1191917116,20190130,0,9681
20190702,9866,185,1215816557,20190130,0,9866
20190703,9810,-56,1211468570,20190130,0,9810
20190704,9898,88,1222841217,20190130,0,9898
20190705,9908,10,1222698685,20190130,0,9908
20190708,9923,15,1224574865,20190130,0,9923
20190709,9831,-92,1223590533,20190130,0,9831
20190710,9947,116,1235671033,20190130,0,9947
20190711,9969,22,1237773816,20190130,0,9969
20190712,10008,39,1242011544,20190130,0,10008
20190716,10125,117,1249956020,20190130,0,10125
20190717,10116,-9,1248964832,20190130,0,10116
20190718,10049,-67,1239877354,20190130,0,10049
20190719,9895,-154,1221313253,20190130,0,9895
20190722,9850,-45,1215810402,20190130,0,9850
20190723,9935,85,1226327254,20190130,0,9935
20190724,10068,133,1239895496,20190130,0,10068
20190725,10179,111,1254494958,20190130,0,10179
20190726,9975,-204,1228202070,20190130,0,9975
20190729,10155,180,1251260055,20190130,0,10155
20190730,10174,19,1255506572,20190130,0,10174
20190731,10112,-62,1248918211,20190130,0,10112
20190801,10120,8,1249752791,20190130,0,10120
20190802,9750,-370,1201554726,20190130,0,9750
20190805,9566,-184,1178824760,20190130,0,9566
20190806,9085,-481,1120992475,20190130,0,9085
20190807,9236,151,1131261391,20190130,0,9236
20190808,9274,38,1140345356,20190130,0,9274
20190809,9465,191,1168205625,20190130,0,9465
20190813,9137,-328,1132746580,20190130,0,9137
20190814,9452,315,1172737753,20190130,0,9452
20190815,9094,-358,1130315858,20190130,0,9094
20190816,9097,3,1128274703,20190130,0,9097
20190819,9342,245,1160103602,20190130,0,9342
20190820,9651,309,1198107592,20190130,0,9651
20190821,9589,-62,1189323172,20190130,0,9589
20190822,9632,43,1195044554,20190130,0,9632
20190823,9567,-65,1187028367,20190130,0,9567
20190826,9084,-483,1127022625,20190130,0,9084
20190827,9281,197,1150946820,20190130,0,9281
20190828,9246,-35,1148625610,20190130,0,9246
20190829,9283,37,1155425607,20190130,0,9283
20190830,9521,238,1189453742,20190130,0,9521
20190902,9509,-12,1187091899,20190130,0,9509
20190903,9526,17,1188832732,20190130,0,9526
20190904,9365,-161,1168832377,20190130,0,9365
20190905,9528,163,1189001385,20190130,0,9528
20190906,9873,345,1232273598,20190130,0,9873
20190909,9790,-83,1222164031,20190130,0,9790
20190910,9880,90,1233675188,20190130,0,9880
20190911,9909,29,1237164014,20190130,0,9909
20190912,10083,174,1258127380,20190130,0,10083
20190913,10118,35,1263244709,20190130,0,10118
20190917,10022,-96,1250983715,20190130,0,10022
20190918,10075,53,1258414726,20190130,0,10075
20190919,10075,0,1252097387,20190130,0,10075
20190920,10019,-56,1245395324,20190130,0,10019
20190924,9784,-235,1215914146,20190130,0,9784
20190925,9416,-368,1169883082,20190130,0,9416
20190926,9722,306,1207373240,20190130,0,9722
20190927,9751,29,1211349943,20190130,0,9751
20190930,9571,-180,1189375943,20190130,0,9571
20191001,9666,95,1202106033,20190130,0,9666
20191002,9583,-83,1191819232,20190130,0,9583
20191003,9441,-142,1174969137,20190130,0,9441
20191004,9517,76,1184935485,20190130,0,9517
20191007,9593,76,1194688842,20190130,0,9593
20191008,9657,64,1203229473,20190130,0,9657
20191009,9460,-197,1179763949,20190130,0,9460
20191010,9566,106,1193494392,20190130,0,9566
20191011,9757,191,1217287906,20190130,0,9757
20191015,9978,221,1245962822,20190130,0,9978
20191016,10178,200,1270348185,20190130,0,10178
20191017,10198,20,1274868940,20190130,0,10198
20191018,10237,39,1272056344,20190130,0,10237
20191021,9976,-261,1233735757,20190130,0,9976
20191023,9958,-18,1230093139,20190130,0,9958
20191024,10043,85,1239388632,20190130,0,10043
20191025,10084,41,1244171041,20190130,0,10084
20191028,10286,202,1268659353,20190130,0,10286
20191029,10410,124,1282764185,20190130,0,10410
20191030,10234,-176,1257590978,20190130,0,10234
20191031,10276,42,1254695686,20190130,0,10276
20191101,10195,-81,1238278216,20190130,0,10195
20191105,10540,345,1280028265,20190130,0,10540
20191106,10533,-7,1277646369,20190130,0,10533
20191107,10529,-4,1274731107,20190130,0,10529
20191108,10773,244,1295119982,20190130,0,10773
20191111,10798,25,1296980857,20190130,0,10798
20191112,10796,-2,1296085339,20190130,0,10796
20191113,10823,27,1296462608,20190130,0,10823
20191114,10690,-133,1278194145,20190130,0,10690
20191115,10714,24,1278473669,20190130,0,10714
20191118,10781,67,1284701550,20190130,0,10781
20191119,10829,48,1289772256,20190130,0,10829
20191120,10844,15,1317953830,20190130,0,10844
20191121,10756,-88,1258333160,20190130,0,10756
20191122,10837,81,1265826561,20190130,0,10837
20191125,10800,-37,1258779004,20190130,0,10800
20191126,11021,221,1284257341,20190130,0,11021
20191127,10985,-36,1278951446,20190130,0,10985
20191128,11130,145,1293842278,20190130,0,11130
20191129,11148,18,1292926663,20190130,0,11148
20191202,11099,-49,1287239537,20190130,0,11099
20191203,10917,-182,1266370056,20190130,0,10917
20191204,10769,-148,1247509466,20190130,0,10769
20191205,10805,36,1245381276,20190130,0,10805
20191206,10850,45,1242437660,20190130,0,10850
20191209,10941,91,1252392539,20190130,0,10941
20191210,10908,-33,1248941253,20190130,0,10908
20191211,10930,22,1252291723,20190130,0,10930
20191212,11038,108,1274885280,20190130,0,11038
20191213,11226,188,1295459965,20190130,0,11226
20191216,11200,-26,1288163939,20190130,0,11200
20191217,11458,258,1302135109,20190130,0,11458
20191218,11524,66,1307144140,20190130,0,11524
20191219,11700,176,1319534954,20190130,0,11700
20191220,11840,140,1288381796,20190130,0,11840
20191223,11883,43,1288484654,20190130,0,11883
20191224,11973,90,1332281703,20190130,0,11973
20191225,11960,-13,1331629586,20190130,0,11960
20191226,11984,24,1340926911,20190130,0,11984
20191227,12129,145,1357103682,20190130,0,12129
20191230,12065,-64,1364008494,20190130,0,12065
20200106,12008,-57,1365934443,20190130,0,12008
20200107,12212,204,1396056638,20190130,0,12212
20200108,12233,21,1376820135,20190130,0,12233
20200109,12555,322,1418400083,20190130,0,12555
20200110,12681,126,1438375185,20190130,0,12681
20200114,13038,357,1490966879,20190130,0,13038
20200115,12930,-108,1508534379,20190130,0,12930
20200116,12877,-53,1547156542,20190130,0,12877
20200117,12993,116,1599445000,20190130,0,12993
20200120,13027,34,1614522524,20190130,0,13027
20200121,13033,6,1623863767,20190130,0,13033
20200122,13040,7,1624687746,20190130,0,13040
20200123,13029,-11,1682561906,20190130,0,13029
20200124,13086,57,1698952304,20190130,0,13086
20200127,12861,-225,1682098865,20190130,0,12861
20200128,12527,-334,1648751078,20190130,0,12527
20200129,12777,250,1647113297,20190130,0,12777
20200130,12860,83,1644022413,20200130,0,12860
20200131,12941,81,1661767577,20200130,0,12941
20200203,12759,-182,1621621113,20200130,0,12759
20200204,13379,620,1704251369,20200130,0,13379
20200205,14036,657,1768069199,20200130,0,14036
20200206,13628,-408,1719728780,20200130,0,13628
20200207,13950,322,1848662029,20200130,0,13950
20200210,13816,-134,1873646517,20200130,0,13816
20200212,14046,230,1916820915,20200130,0,14046
20200213,14259,213,1962432998,20200130,0,14259
20200214,14322,63,1987638767,20200130,0,14322
20200217,14371,49,2008806009,20200130,0,14371
20200218,14379,8,2041328137,20200130,0,14379
20200219,14673,294,2083181540,20200130,0,14673
20200220,15196,523,2171245505,20200130,0,15196
20200221,15128,-68,2172425791,20200130,0,15128
20200225,13927,-1201,2143289602,20200130,0,13927
20200226,13505,-422,2170613307,20200130,0,13505
20200227,13557,52,2256107430,20200130,0,13557
20200228,12688,-869,2056493251,20200130,0,12688
20200302,12585,-103,1985529341,20200130,0,12585
20200303,13280,695,2029209375,20200130,0,13280
20200304,12836,-444,2041541117,20200130,0,12836
20200305,13276,440,2183728715,20200130,0,13276
20200306,12720,-556,2173312596,20200130,0,12720
20200309,11910,-810,2060783224,20200130,0,11910
20200310,11208,-702,1986037516,20200130,0,11208
20200311,12010,802,2073591691,20200130,0,12010
20200312,11470,-540,1988808713,20200130,0,11470
20200313,10378,-1092,1801436160,20200130,0,10378
20200316,11199,821,1944273210,20200130,0,11199
20200317,9723,-1476,1577798129,20200130,0,9723
20200318,10165,442,1663087782,20200130,0,10165
20200319,9791,-374,1606057392,20200130,0,9791
20200323,10284,493,1708014491,20200130,0,10284
20200324,10430,146,1735060411,20200130,0,10430
20200325,11280,850,1888839983,20200130,0,11280
20200326,11203,-77,1911130530,20200130,0,11203
20200327,11413,210,2030997964,20200130,0,11413
20200330,10922,-491,1944756581,20200130,0,10922
20200331,11307,385,2032987455,20200130,0,11307
20200401,11249,-58,2009677564,20200130,0,11249
20200402,10693,-556,1914316415,20200130,0,10693
20200403,10800,107,1914741753,20200130,0,10800
20200406,10776,-24,1937908273,20200130,0,10776
20200407,11546,770,2081112692,20200130,0,11546
20200408,11549,3,2047707883,20200130,0,11549
20200409,11768,219,2124648680,20200130,0,11768
20200410,11795,27,2141138402,20200130,0,11795
20200413,11753,-42,2135010541,20200130,0,11753
20200414,12129,376,2203362162,20200130,0,12129
20200415,12649,520,2322679915,20200130,0,12649
20200416,12789,140,2364992236,20200130,0,12789
20200417,13051,262,2426262046,20200130,0,13051
20200420,13007,-44,2445995583,20200130,0,13007
20200421,12989,-18,2494047888,20200130,0,12989
20200422,12491,-498,2460904390,20200130,0,12491
20200423,12941,450,2547243880,20200130,0,12941
20200424,12855,-86,2513454557,20200130,0,12855
20200427,13027,172,2561601926,20200130,0,13027
20200428,13153,126,2613943611,20200130,0,13153
20200430,13282,129,2657376972,20200130,0,13282
20200501,13334,52,2687580341,20200130,0,13334
20200507,13124,-210,2717417158,20200130,0,13124
20200508,13309,185,2772214001,20200130,0,13309
20200511,13646,337,2895316818,20200130,0,13646
20200512,13841,195,2280603335,20200130,0,13841
20200513,13539,-302,2257753576,20200130,0,13539
20200514,13335,-204,2244786582,20200130,0,13335
20200515,13558,223,2288026009,20200130,0,13558
20200518,13770,212,2319037235,20200130,0,13770
20200519,14125,355,2376604490,20200130,0,14125
20200520,14273,148,2419000077,20200130,0,14273
20200521,14555,282,2483631872,20200130,0,14555
20200522,14469,-86,2526697049,20200130,0,14469
20200525,14350,-119,2551406312,20200130,0,14350
20200526,14367,17,2580580391,20200130,0,14367
20200527,14348,-19,2577173891,20200130,0,14348
20200528,14312,-36,2616133715,20200130,0,14312
20200529,14073,-239,2569238613,20200130,0,14073
20200601,14293,220,2530929656,20200130,0,14293
20200602,14517,224,2552616459,20200130,0,14517
20200603,14738,221,2604273561,20200130,0,14738
20200604,14946,208,2641608542,20200130,0,14946
20200605,14739,-207,2601836818,20200130,0,14739
20200608,15120,381,2682793164,20200130,0,15120
20200609,15175,55,2684102005,20200130,0,15175
20200610,15313,138,2739953979,20200130,0,15313
20200611,15462,149,2823800044,20200130,0,15462
20200612,14707,-755,2704784290,20200130,0,14707
20200615,14853,146,2742417622,20200130,0,14853
20200616,15132,279,2788560602,20200130,0,15132
20200617,15382,250,2836754164,20200130,0,15382
20200618,15386,4,2928478065,20200130,0,15386
20200619,15424,38,2981679152,20200130,0,15424
20200622,15372,-52,3001758618,20200130,0,15372
20200623,15582,210,3125399328,20200130,0,15582
20200624,15635,53,3169285434,20200130,0,15635
20200625,15358,-277,3154285657,20200130,0,15358
20200626,15512,154,3279493114,20200130,0,15512
20200629,14883,-629,3129955742,20200130,0,14883
20200630,15154,271,3205351680,20200130,0,15154
20200701,15519,365,3167425693,20200130,0,15519
20200702,15816,297,3254557378,20200130,0,15816
20200703,16044,228,3423336519,20200130,0,16044
20200706,16060,16,3453594475,20200130,0,16060
20200707,16871,811,3627974912,20200130,0,16871
20200708,16861,-10,3724815842,20200130,0,16861
20200709,17264,403,3882401303,20200130,0,17264
20200710,17496,232,4064983641,20200130,0,17496
20200713,17831,335,4261773867,20200130,0,17831
20200714,17346,-485,4305198954,20200130,0,17346
20200715,17438,92,4616030388,20200130,0,17438
20200716,17428,-10,4753584194,20200130,0,17428
20200717,17294,-134,4868712552,20200130,0,17294
20200720,17259,-35,4889060598,20200130,0,17259
20200721,17893,634,5135575603,20200130,0,17893
20200722,17585,-308,5074336373,20200130,0,17585
20200727,16740,-845,4914522073,20200130,0,16740
20200728,16984,244,4988612343,20200130,0,16984
20200729,16665,-319,4880290199,20200130,0,16665
20200730,16907,242,5169558913,20200130,0,16907
20200731,16853,-54,5160973830,20200130,0,16853
20200803,17321,468,5324242834,20200130,0,17321
20200804,17563,242,5442792017,20200130,0,17563
20200805,17658,95,5576222245,20200130,0,17658
20200806,17698,40,5656350626,20200130,0,17698
20200807,17999,301,5808584131,20200130,0,17999
20200811,17651,-348,5752884217,20200130,0,17651
20200812,17372,-279,5697040153,20200130,0,17372
20200813,18033,661,6020756387,20200130,0,18033
20200814,18242,209,6142439729,20200130,0,18242
20200817,18122,-120,6219702620,20200130,0,18122
20200818,18541,419,6429968121,20200130,0,18541
20200819,18688,147,6589283551,20200130,0,18688
20200820,18784,96,6727000900,20200130,0,18784
20200821,19081,297,7006605225,20200130,0,19081
20200824,19381,300,7168545840,20200130,0,19381
20200825,19567,186,7453625443,20200130,0,19567
20200826,19869,302,8006978863,20200130,0,19869
20200827,20519,650,8660629388,20200130,0,20519
20200828,20472,-47,9000999013,20200130,0,20472
20200831,20355,-117,9358146250,20200130,0,20355
20200901,20935,580,10066931909,20200130,0,20935
20200902,21235,300,10545982662,20200130,0,21235
20200903,21292,57,10798121528,20200130,0,21292
20200904,19997,-1295,10564971823,20200130,0,19997
20200907,19807,-190,10697677925,20200130,0,19807
20200908,19798,-9,10551641623,20200130,0,19798
20200909,18366,-1432,9788503060,20200130,0,18366
20200910,19060,694,9928587962,20200130,0,19060
20200911,18706,-354,9463841212,20200130,0,18706
20200914,18665,-41,9557222368,20200130,0,18665
20200915,19105,440,9783180512,20200130,0,19105
20200916,19527,422,9997568348,20200130,0,19527
20200917,19149,-378,9919624596,20200130,0,19149
20200918,18720,-429,9880696622,20200130,0,18720
20200923,19167,447,10142225552,20200130,0,19167
20200924,18696,-471,9902224537,20200130,0,18696
20200925,18732,36,9980890555,20200130,0,18732
20200928,19122,390,9870868356,20200130,0,19122
20200929,19453,331,10096871110,20200130,0,19453
20200930,19561,108,10222551797,20200130,0,19561
20201001,19831,270,10472456342,20200130,0,19831
20201002,20236,405,10725754287,20200130,0,20236
20201005,19630,-606,10421483409,20200130,0,19630
20201006,20085,455,10945580375,20200130,0,20085
20201007,19737,-348,10845363296,20200130,0,19737
20201008,20174,437,11141005408,20200130,0,20174
20201009,20237,63,11182443632,20200130,0,20237
20201012,20350,113,11236137997,20200130,0,20350
20201013,20956,606,11575486494,20200130,0,20956
20201014,20947,-9,11515422428,20200130,0,20947
20201015,20850,-97,11502539583,20200130,0,20850
20201016,20627,-223,11306733740,20200130,0,20627
20201019,20513,-114,11162311980,20200130,0,20513
20201020,20255,-258,11032580655,20200130,0,20255
20201021,20359,104,11075251411,20200130,0,20359
20201022,20384,25,10969927044,20200130,0,20384
20201023,20327,-57,10887610890,20200130,0,20327
20201026,20487,160,10828980597,20200130,0,20487
20201027,20218,-269,10675755564,20200130,0,20218
20201028,20553,335,10817993197,20200130,0,20553
20201029,19684,-869,10370637196,20200130,0,19684
20201030,20363,679,10750741924,20200130,0,20363
20201102,19278,-1085,10155126617,20200130,0,19278
20201104,19500,222,10265140641,20200130,0,19500
20201105,20295,795,10874442403,20200130,0,20295
20201106,20612,317,11375560929,20200130,0,20612
20201109,20605,-7,11658777513,20200130,0,20605
20201110,20309,-296,11551283827,20200130,0,20309
20201111,19789,-520,11334356394,20200130,0,19789
20201112,20226,437,11350215992,20200130,0,20226
20201113,20017,-209,11086296520,20200130,0,20017
20201116,20015,-2,11096475574,20200130,0,20015
20201117,20017,2,11084606991,20200130,0,20017
20201118,19954,-63,11002490544,20200130,0,19954
20201119,20002,48,10945113755,20200130,0,20002
20201120,20074,72,10947105386,20200130,0,20074
20201124,20136,62,10894973424,20200130,0,20136
20201125,20501,365,11136913566,20200130,0,20501
20201126,20712,211,11230481905,20200130,0,20712
20201127,20674,-38,11151746092,20200130,0,20674
20201130,20810,136,11224841605,20200130,0,20810
20201201,20704,-106,11191250621,20200130,0,20704
20201202,21097,393,11452147192,20200130,0,21097
20201203,21177,80,11548662422,20200130,0,21177
20201204,21113,-64,11516784459,20200130,0,21113
20201207,21170,57,11546649477,20200130,0,21170
20201208,21474,304,11744520846,20200130,0,21474
20201209,21473,-1,11748183642,20200130,0,21473
20201210,21068,-405,11469440928,20200130,0,21068
20201211,21438,370,11687050925,20200130,0,21438
20201214,21415,-23,11661585925,20200130,0,21415
20201215,21661,246,11807932764,20200130,0,21661
20201216,22046,385,12045315797,20200130,0,22046
20201217,22158,112,12065348172,20200130,0,22158
20201218,22325,167,12179019841,20200130,0,22325
20201221,22511,186,12403463383,20200130,0,22511
20201222,22306,-205,12422480932,20200130,0,22306
20201223,22273,-33,12540221510,20200130,0,22273
20201224,22179,-94,12461160577,20200130,0,22179
20201225,21867,-312,12316009621,20200130,0,21867
20201228,21896,29,12397375542,20200130,0,21896
20201229,22288,392,12619427092,20200130,0,22288
20201230,22395,107,12659197423,20200130,0,22395
20210104,22578,183,12795041290,20200130,0,22578
20210105,22408,-170,12742329509,20200130,0,22408
20210106,22498,90,12847396332,20200130,0,22498
20210107,21945,-553,12609214098,20200130,0,21945
20210108,22689,744,13030406951,20200130,0,22689
20210112,22543,-146,12842610539,20200130,0,22543
20210113,22606,63,12863355485,20200130,0,22606
20210114,22893,287,13007795693,20200130,0,22893
20210115,22771,-122,12871377362,20200130,0,22771
20210118,22491,-280,12625330881,20200130,0,22491
20210119,22471,-20,12632134616,20200130,0,22471
20210120,23030,559,12946385266,20200130,0,23030
20210121,24055,1025,13454816267,20200130,0,24055
20210122,24069,14,13473363654,20200130,0,24069
20210125,24146,77,13543149288,20200130,0,24146
20210126,24336,190,13666700683,20200130,0,24336
20210127,24420,84,13873958815,20200130,0,24420
20210128,23721,-699,13452802290,20200130,0,23721
20210129,23894,173,13655863559,20200130,0,23894
20210201,23345,-549,13329258532,20210201,0,23345
20210202,24128,783,13785936675,20210201,0,24128
20210203,24543,415,14104432035,20210201,0,24543
20210204,24669,126,14276616617,20210201,0,24669
20210205,25114,445,14680304660,20210201,0,25114
20210208,25309,195,14874454145,20210201,0,25309
20210209,25464,155,15087254365,20210201,0,25464
20210210,25602,138,15373611338,20210201,0,25602
20210212,26197,595,15795407117,20210201,0,26197
20210215,26441,244,16039131129,20210201,0,26441
20210216,26534,93,16323839101,20210201,0,26534
20210217,26977,443,16596632267,20210201,0,26977
20210218,26471,-506,16845926881,20210201,0,26471
20210219,26182,-289,16783733884,20210201,0,26182
20210222,26438,256,17108014696,20210201,0,26438
20210224,25653,-785,16621242538,20210201,0,25653
20210225,25736,83,16755599406,20210201,0,25736
20210226,24925,-811,16157884504,20210201,0,24925
20210301,25009,84,16216896897,20210201,0,25009
20210302,25804,795,16482393230,20210201,0,25804
20210303,25291,-513,16225589942,20210201,0,25291
20210304,24392,-899,15710811146,20210201,0,24392
20210305,23931,-461,15495362356,20210201,0,23931
20210308,24231,300,15669338255,20210201,0,24231
20210309,23124,-1107,14878271390,20210201,0,23124
20210310,24566,1442,15845428586,20210201,0,24566
20210311,24220,-346,15559705017,20210201,0,24220
20210312,25188,968,16183003499,20210201,0,25188
20210315,24875,-313,16077622728,20210201,0,24875
20210316,25232,357,16415091387,20210201,0,25232
20210317,25201,-31,16508485748,20210201,0,25201
20210318,25538,337,16783661170,20210201,0,25538
20210319,24646,-892,16250156317,20210201,0,24646
20210322,24711,65,16333180474,20210201,0,24711
20210323,25023,312,16550483499,20210201,0,25023
20210324,24898,-125,16509737673,20210201,0,24898
20210325,24133,-765,16013494578,20210201,0,24133
20210326,23679,-454,15731960735,20210201,0,23679
20210329,23882,203,15881038062,20210201,0,23882
20210330,24146,264,16088871583,20210201,0,24146
20210331,24436,290,16309411612,20210201,0,24436
20210401,24872,436,16553701536,20210201,0,24872
20210402,25182,310,16771415680,20210201,0,25182
20210405,25175,-7,16872781679,20210201,0,25175
20210406,25610,435,17164509741,20210201,0,25610
20210407,25665,55,17332300409,20210201,0,25665
20210408,25809,144,17442152873,20210201,0,25809
20210409,26043,234,17628371653,20210201,0,26043
20210412,26152,109,17714795990,20210201,0,26152
20210413,26428,276,17973778671,20210201,0,26428
20210414,26712,284,18183663571,20210201,0,26712
20210415,26160,-552,17828302535,20210201,0,26160
20210416,26546,386,18173360257,20210201,0,26546
20210419,26438,-108,18171740677,20210201,0,26438
20210420,25975,-463,17939711827,20210201,0,25975
20210421,25677,-298,17834890071,20210201,0,25677
20210422,25743,66,17867872698,20210201,0,25743
20210423,25267,-476,17374458268,20210201,0,25267
20210426,25713,446,17713163834,20210201,0,25713
20210427,25915,202,17799778221,20210201,0,25915
20210428,25920,5,17839723467,20210201,0,25920
20210430,26096,176,17970547198,20210201,0,26096
20210506,24775,-1321,17079661706,20210201,0,24775
20210507,24840,65,17231461173,20210201,0,24840
20210510,24855,15,17388527497,20210201,0,24855
20210511,24007,-848,16826165604,20210201,0,24007
20210512,24073,66,16970198747,20210201,0,24073
20210513,23595,-478,16650091467,20210201,0,23595
20210514,23423,-172,16516495507,20210201,0,23423
20210517,24013,590,16875824651,20210201,0,24013
20210518,23974,-39,16854542614,20210201,0,23974
20210519,23797,-177,16800850644,20210201,0,23797
20210520,23831,34,16848922271,20210201,0,23831
20210521,24320,489,17223166455,20210201,0,24320
20210524,24150,-170,17076647357,20210201,0,24150
20210525,24666,516,17464639137,20210201,0,24666
20210526,24714,48,17518827642,20210201,0,24714
20210527,24958,244,17715283558,20210201,0,24958
20210528,25135,177,17866687784,20210201,0,25135
20210531,25166,31,17912047468,20210201,0,25166
20210601,25085,-81,17894979738,20210201,0,25085
20210602,25233,148,18000195108,20210201,0,25233
20210603,25216,-17,18105124431,20210201,0,25216
20210604,25006,-210,17919215954,20210201,0,25006
20210607,25367,361,18143347174,20210201,0,25367
20210608,25390,23,18152412649,20210201,0,25390
20210609,25340,-50,17973523040,20210201,0,25340
20210610,25309,-31,17880888725,20210201,0,25309
20210611,25466,157,17965308945,20210201,0,25466
20210614,25606,140,18063514619,20210201,0,25606
20210615,26019,413,18357130093,20210201,0,26019
20210616,25736,-283,18170205405,20210201,0,25736
20210617,25847,111,18228344076,20210201,0,25847
20210618,26205,358,18449761452,20210201,0,26205
20210621,26109,-96,18314863801,20210201,0,26109
20210622,26147,38,18331409784,20210201,0,26147
20210623,26642,495,18589012315,20210201,0,26642
20210624,27086,444,18909060348,20210201,0,27086
20210625,27397,311,19118262128,20210201,0,27397
20210628,27477,80,19171546917,20210201,0,27477
20210629,27900,423,19408330639,20210201,0,27900
20210630,27965,65,19562432480,20210201,0,27965
20210701,27930,-35,19670004238,20210201,0,27930
20210702,28061,131,19785746943,20210201,0,28061
20210705,28086,25,19899639822,20210201,0,28086
20210706,28011,-75,19942646124,20210201,0,28011
20210707,27897,-114,19861178244,20210201,0,27897
20210708,27676,-221,19886027725,20210201,0,27676
20210709,27104,-572,19485454846,20210201,0,27104
20210712,27549,445,19798121116,20210201,0,27549
20210713,27858,309,19932969231,20210201,0,27858
20210714,27923,65,20070591031,20210201,0,27923
20210715,27719,-204,19968426408,20210201,0,27719
20210716,27455,-264,19820268191,20210201,0,27455
20210719,26944,-511,19496930960,20210201,0,26944
20210720,26691,-253,19320799943,20210201,0,26691
20210721,27107,416,19564883233,20210201,0,27107
20210726,27741,634,20115252645,20210201,0,27741
20210727,27327,-414,19855187076,20210201,0,27327
20210728,26846,-481,19510202021,20210201,0,26846
20210729,27283,437,19764171459,20210201,0,27283
20210730,27250,-33,19706352051,20210201,0,27250
20210802,26989,-261,19523547548,20210201,0,26989
20210803,27060,71,19582001405,20210201,0,27060
20210804,26965,-95,19553343083,20210201,0,26965
20210805,27287,322,19738554456,20210201,0,27287
20210806,27558,271,19928900196,20210201,0,27558
20210810,27422,-136,19733351852,20210201,0,27422
20210811,27318,-104,19668528259,20210201,0,27318
20210812,27113,-205,19420140975,20210201,0,27113
20210813,27189,76,19472217891,20210201,0,27189
20210816,26870,-319,19187954958,20210201,0,26870
20210817,26534,-336,18922530157,20210201,0,26534
20210818,26097,-437,18530651239,20210201,0,26097
20210819,26056,-41,18215121077,20210201,0,26056
20210820,25959,-97,18118663689,20210201,0,25959
20210823,26240,281,18213747649,20210201,0,26240
20210824,26864,624,18653715990,20210201,0,26864
20210825,27240,376,18888326159,20210201,0,27240
20210826,27318,78,18924840316,20210201,0,27318
20210827,27079,-239,18744178769,20210201,0,27079
20210830,27296,217,18891826300,20210201,0,27296
20210831,27767,471,19214591439,20210201,0,27767
20210901,27939,172,19308317568,20210201,0,27939
20210902,28247,308,19435035485,20210201,0,28247
20210903,28070,-177,19299851918,20210201,0,28070
20210906,28150,80,19344768891,20210201,0,28150
20210907,28137,-13,19283893642,20210201,0,28137
20210908,28656,519,19639817604,20210201,0,28656
20210909,28306,-350,19340592264,20210201,0,28306
20210910,28056,-250,19052377475,20210201,0,28056
20210913,27888,-168,18925862176,20210201,0,27888
20210914,27730,-158,18833365160,20210201,0,27730
20210915,27478,-252,18651742405,20210201,0,27478
20210916,27621,143,18735808258,20210201,0,27621
20210917,27680,59,18801882973,20210201,0,27680
20210921,26615,-1065,18094004889,20210201,0,26615
20210922,26684,69,18205944256,20210201,0,26684
20210924,27611,927,18750536389,20210201,0,27611
20210927,27648,37,18783198869,20210201,0,27648
20210928,27679,31,18877542608,20210201,0,27679
20210929,27130,-549,18522374571,20210201,0,27130
20210930,26998,-132,18430597465,20210201,0,26998
20211001,26938,-60,18378749444,20210201,0,26938
20211004,26915,-23,18381023327,20210201,0,26915
20211005,26090,-825,17904548168,20210201,0,26090
20211006,26844,754,18424617470,20210201,0,26844
20211007,27008,164,18502898263,20210201,0,27008
20211008,27650,642,18924722567,20210201,0,27650
20211011,27911,261,19124307258,20210201,0,27911
20211012,28070,159,19258053747,20210201,0,28070
20211013,27924,-146,19162199228,20210201,0,27924
20211014,28214,290,19344932693,20210201,0,28214
20211015,28674,460,19644837283,20210201,0,28674
20211018,28956,282,19817718093,20210201,0,28956
20211019,29515,559,20188221860,20210201,0,29515
20211020,30100,585,20563201762,20210201,0,30100
20211021,29893,-207,20350442576,20210201,0,29893
20211022,30158,265,20510693514,20210201,0,30158
20211025,29682,-476,20120988753,20210201,0,29682
20211026,30177,495,20455086862,20210201,0,30177
20211027,30155,-22,20441483429,20210201,0,30155
20211028,29881,-274,20316867896,20210201,0,29881
20211029,30240,359,20591417105,20210201,0,30240
20211101,30397,157,20703442861,20210201,0,30397
20211102,30951,554,21107227121,20210201,0,30951
20211104,31109,158,21365096456,20210201,0,31109
20211105,31410,301,21621889553,20210201,0,31410
20211108,31108,-302,21429598981,20210201,0,31108
20211109,31057,-51,21464703964,20210201,0,31057
20211110,30431,-626,21206834589,20210201,0,30431
20211111,30442,11,21280964930,20210201,0,30442
20211112,30818,376,21564288280,20210201,0,30818
20211115,31056,238,21652914381,20210201,0,31056
20211116,31031,-25,21649920262,20210201,0,31031
20211117,31438,407,22015241951,20210201,0,31438
20211118,30960,-478,21726623282,20210201,0,30960
20211119,30987,27,21802193772,20210201,0,30987
20211122,31180,193,21992423607,20210201,0,31180
20211124,30697,-483,21709909480,20210201,0,30697
20211125,31031,334,21986850292,20210201,0,31031
20211126,30923,-108,21943007949,20210201,0,30923
20211129,30014,-909,21297901107,20210201,0,30014
20211130,30535,521,21690226962,20210201,0,30535
20211201,29942,-593,21240681471,20210201,0,29942
20211202,29061,-881,20689565593,20210201,0,29061
20211203,29133,72,20880300581,20210201,0,29133
20211206,28084,-1049,20160900172,20210201,0,28084
20211207,28835,751,20782286950,20210201,0,28835
20211208,29771,936,21440581589,20210201,0,29771
20211209,30023,252,21727869821,20210201,0,30023
20211210,29380,-643,21303638985,20210201,0,29380
20211213,29476,96,21363167464,20210201,0,29476
20211214,28717,-759,20813115499,20210201,0,28717
20211215,28665,-52,20790917719,20210201,0,28665
20211216,29313,648,21268376669,20210201,0,29313
20211217,28295,-1018,20579584614,20210201,0,28295
20211220,28152,-143,20541605669,20210201,0,28152
20211221,27653,-499,20214308670,20210201,0,27653
20211222,28701,1048,21033040834,20210201,0,28701
20211223,28990,289,21248399145,20210201,0,28990
20211224,29366,376,21561075071,20210201,0,29366
20211227,29344,-22,21547313170,20210201,0,29344
20211228,29860,516,21926313428,20210201,0,29860
20211229,29617,-243,21786739218,20210201,0,29617
20211230,29409,-208,21678716597,20210201,0,29409
20220104,30190,781,22256072368,20210201,0,30190
20220105,29880,-310,22033528676,20210201,0,29880
20220106,28856,-1024,21389797172,20210201,0,28856
20220107,29004,148,21487143037,20210201,0,29004
20220111,28707,-297,21239946837,20210201,0,28707
20220112,29145,438,21587812735,20210201,0,29145
20220113,29331,186,21718676409,20210201,0,29331
20220114,28105,-1226,20836629504,20210201,0,28105
20220117,28470,365,21128421710,20210201,0,28470
20220118,28524,54,21186843348,20210201,0,28524
20220119,27865,-659,20696894137,20210201,0,27865
20220120,27507,-358,20396452101,20210201,0,27507
20220121,27309,-198,20191765102,20210201,0,27309
20220124,25858,-1451,19100941320,20210201,0,25858
20220125,25655,-203,18881293984,20210201,0,25655
20220126,25060,-595,18363013043,20210201,0,25060
20220127,25171,111,18345008459,20210201,0,25171
20220128,24965,-206,18109174469,20210201,0,24965
20220131,25707,742,18634445881,20220131,0,25707
20220201,27140,1433,19643594415,20220131,0,27140
20220202,27338,198,19816404347,20220131,0,27338
20220203,27264,-74,19897113364,20220131,0,27264
20220204,25859,-1405,18947271199,20220131,0,25859
20220207,26474,615,19399698016,20220131,0,26474
20220208,25969,-505,19037306871,20220131,0,25969
20220209,26540,571,19479165757,20220131,0,26540
20220210,27198,658,19918228357,20220131,0,27198
20220214,25668,-1530,18780602658,20220131,0,25668
20220215,25811,143,18888789084,20220131,0,25811
20220216,26709,898,19472159867,20220131,0,26709
20220217,26615,-94,19413557511,20220131,0,26615
20220218,25667,-948,18743191485,20220131,0,25667
20220221,25122,-545,18352934810,20220131,0,25122
20220222,25062,-60,18311377936,20220131,0,25062
20220224,23769,-1293,17366034414,20220131,0,23769
20220225,24688,919,18004261841,20220131,0,24688
20220228,24960,272,18067968161,20220131,0,24960
20220301,25081,121,18185277183,20220131,0,25081
20220302,24932,-149,18148886027,20220131,0,24932
20220303,25243,311,18477569698,20220131,0,25243
20220304,24605,-638,18038145061,20220131,0,24605
20220307,24006,-599,17615114503,20220131,0,24006
20220308,23039,-967,16901319112,20220131,0,23039
20220309,23052,13,16879739962,20220131,0,23052
20220310,24108,1056,17529253786,20220131,0,24108
20220311,23668,-440,17200412812,20220131,0,23668
20220314,22920,-748,16665930226,20220131,0,22920
20220315,22151,-769,16099147488,20220131,0,22151
20220316,22874,723,16635034725,20220131,0,22874
20220317,25328,2454,18424543910,20220131,0,25328
20220318,25416,88,18554800394,20220131,0,25416
20220322,26397,981,19359618770,20220131,0,26397
20220323,27622,1225,20313605742,20220131,0,27622
20220324,27414,-208,20118249749,20220131,0,27414
20220325,28069,655,20641848719,20220131,0,28069
20220328,27966,-103,20555732715,20220131,0,27966
20220329,28992,1026,21306357127,20220131,0,28992
20220330,28995,3,21297553945,20220131,0,28995
20220331,28590,-405,20949175417,20220131,0,28590
20220401,27721,-869,20268129163,20220131,0,27721
20220404,27982,261,20408703114,20220131,0,27982
20220405,29175,1193,21348076252,20220131,0,29175
20220406,28525,-650,20826524897,20220131,0,28525
20220407,27485,-1040,20080379035,20220131,0,27485
20220408,27305,-180,19931143623,20220131,0,27305
20220411,27003,-302,19687363287,20220131,0,27003
20220412,26381,-622,19257396634,20220131,0,26381
20220413,26215,-166,19097836691,20220131,0,26215
20220414,26745,530,19466363505,20220131,0,26745
20220415,26062,-683,18943456363,20220131,0,26062
20220418,26125,63,18998004028,20220131,0,26125
20220419,26331,206,19148116242,20220131,0,26331
20220420,27243,912,19817308897,20220131,0,27243
20220421,25333,-1910,18409190204,20220131,0,25333
20220422,24698,-635,17948791326,20220131,0,24698
20220425,24234,-464,17572933823,20220131,0,24234
20220426,24226,-8,17599124785,20220131,0,24226
20220427,23026,-1200,16742783017,20220131,0,23026
20220428,23311,285,16960684362,20220131,0,23311
20220502,23921,610,17414455437,20220131,0,23921
20220506,23951,30,17469536403,20220131,0,23951
20220509,23515,-436,17260157587,20220131,0,23515
20220510,22085,-1430,16236482439,20220131,0,22085
20220511,22449,364,16529394187,20220131,0,22449
20220512,21421,-1028,15779586806,20220131,0,21421
20220513,21214,-207,15638569591,20220131,0,21214
20220516,22498,1284,16572339670,20220131,0,22498
20220517,22135,-363,16288928064,20220131,0,22135
20220518,22914,779,16870452142,20220131,0,22914
20220519,21511,-1403,15857663027,20220131,0,21511
20220520,21503,-8,15863656787,20220131,0,21503
20220523,21285,-218,15721163263,20220131,0,21285
20220524,21626,341,15995722362,20220131,0,21626
20220525,20493,-1133,15156376729,20220131,0,20493
20220526,20987,494,15522048645,20220131,0,20987
20220527,22118,1131,16295412986,20220131,0,22118
20220530,22811,693,16813077926,20220131,0,22811
20220531,23024,213,16998144503,20220131,0,23024
20220601,23318,294,17214663872,20220131,0,23318
20220602,23306,-12,17282378579,20220131,0,23306
20220603,24153,847,17990093685,20220131,0,24153
20220606,23424,-729,17456676414,20220131,0,23424
20220607,24072,648,17929142639,20220131,0,24072
20220608,24499,427,18233438407,20220131,0,24499
20220609,25246,747,18799426220,20220131,0,25246
20220610,24152,-1094,17926757291,20220131,0,24152
20220613,23429,-723,17384253360,20220131,0,23429
20220614,21766,-1663,16152223379,20220131,0,21766
20220615,22339,573,16506412485,20220131,0,22339
20220616,23036,697,17059511169,20220131,0,23036
20220617,21742,-1294,16111321956,20220131,0,21742
20220620,22392,650,16602704616,20220131,0,22392
20220621,22385,-7,16551965243,20220131,0,22385
20220622,23213,828,17164545240,20220131,0,23213
20220623,23127,-86,17043571987,20220131,0,23127
20220624,23403,276,17240509262,20220131,0,23403
20220627,24347,944,17930349289,20220131,0,24347
20220628,24375,28,18005907106,20220131,0,24375
20220629,23577,-798,17439287559,20220131,0,23577
20220630,23628,51,17472967534,20220131,0,23628
20220701,23048,-580,16984385158,20220131,0,23048
20220704,23085,37,17016745869,20220131,0,23085
20220705,23283,198,17229001083,20220131,0,23283
20220706,23904,621,17688101044,20220131,0,23904
20220707,23941,37,17705911944,20220131,0,23941
20220708,24678,737,18245160957,20220131,0,24678
20220711,24695,17,18269241644,20220131,0,24695
20220712,23710,-985,17546692728,20220131,0,23710
20220713,23435,-275,17340860172,20220131,0,23435
20220714,23666,231,17516968865,20220131,0,23666
20220715,23645,-21,17498965930,20220131,0,23645
20220719,23981,336,17748067516,20220131,0,23981
20220720,24777,796,18342542767,20220131,0,24777
20220721,25389,612,18795596630,20220131,0,25389
20220722,25759,370,19064844906,20220131,0,25759
20220725,24871,-888,18422876464,20220131,0,24871
20220726,24644,-227,18231098894,20220131,0,24644
20220727,24107,-537,17819508451,20220131,0,24107
20220728,25252,1145,18671245743,20220131,0,25252
20220729,24973,-279,18488302274,20220131,0,24973
20220801,24936,-37,18453063777,20220131,0,24936
20220802,24557,-379,18155865129,20220131,0,24557
20220803,25043,486,18576601144,20220131,0,25043
20220804,25781,738,19118453848,20220131,0,25781
20220805,25940,159,19230073346,20220131,0,25940
20220808,25854,-86,19154298332,20220131,0,25854
20220809,25627,-227,18929467764,20220131,0,25627
20220810,25419,-208,18738557812,20220131,0,25419
20220812,25827,408,19005830592,20220131,0,25827
20220815,26364,537,19406019110,20220131,0,26364
20220816,26554,190,19538137011,20220131,0,26554
20220817,26596,42,19564936362,20220131,0,26596
20220818,26290,-306,19299371021,20220131,0,26290
20220819,26612,322,19520769257,20220131,0,26612
20220822,26194,-418,19168899824,20220131,0,26194
20220823,25505,-689,18650204039,20220131,0,25505
20220824,25493,-12,18607016739,20220131,0,25493
20220825,25746,253,18759462150,20220131,0,25746
20220826,26492,746,19301068040,20220131,0,26492
20220829,25654,-838,18697811901,20220131,0,25654
20220830,25431,-223,18510284940,20220131,0,25431
20220831,24922,-509,18115732238,20220131,0,24922
20220901,25164,242,18300327553,20220131,0,25164
20220902,25262,98,18369613488,20220131,0,25262
20220905,24823,-439,18065347305,20220131,0,24823
20220906,24808,-15,18059714743,20220131,0,24808
20220907,24932,124,18149887052,20220131,0,24932
20220908,25777,845,18744501872,20220131,0,25777
20220909,25675,-102,18630435682,20220131,0,25675
20220912,26194,519,19018392626,20220131,0,26194
20220913,26530,336,19246500115,20220131,0,26530
20220914,25127,-1403,18194685997,20220131,0,25127
20220915,25125,-2,18153861230,20220131,0,25125
20220916,24949,-176,18014285109,20220131,0,24949
20220920,25133,184,18151399458,20220131,0,25133
20220921,24997,-136,18047066409,20220131,0,24997
20220922,24493,-504,17680407847,20220131,0,24493
20220926,23646,-847,17063998986,20220131,0,23646
20220927,23615,-31,17022474548,20220131,0,23615
20220928,23654,39,17063932391,20220131,0,23654
20220929,24315,661,17554229186,20220131,0,24315
20220930,23568,-747,17010093524,20220131,0,23568
20221003,23305,-263,16826647292,20220131,0,23305
20221004,23582,277,17028061309,20220131,0,23582
20221005,24185,603,17514319956,20220131,0,24185
20221006,24184,-1,17500095129,20220131,0,24184
20221007,24158,-26,17488318298,20220131,0,24158
20221011,22904,-1254,16578272673,20220131,0,22904
20221012,22293,-611,16142951806,20220131,0,22293
20221013,22450,157,16268028671,20220131,0,22450
20221014,22995,545,16689646902,20220131,0,22995
20221017,22285,-710,16178820171,20220131,0,22285
20221018,23406,1121,17003527283,20220131,0,23406
20221019,23514,108,17104710828,20220131,0,23514
20221020,23605,91,17177935271,20220131,0,23605
20221021,23500,-105,17113109655,20220131,0,23500
20221024,23827,327,17358200180,20220131,0,23827
20221025,23373,-454,17031288729,20220131,0,23373
20221026,23879,506,17396924608,20220131,0,23879
20221027,23059,-820,16803719072,20220131,0,23059
20221028,22204,-855,16184199188,20220131,0,22204
20221031,22723,519,16581933774,20220131,0,22723
20221101,22389,-334,16344022506,20220131,0,22389
20221102,22006,-383,16062733999,20220131,0,22006
20221104,20985,-1021,15365920178,20220131,0,20985
20221107,21282,297,15591525810,20220131,0,21282
20221108,21339,57,15652264680,20220131,0,21339
20221109,21264,-75,15625260386,20220131,0,21264
20221110,20617,-647,15158675486,20220131,0,20617
20221111,21852,1235,16043933034,20220131,0,21852
20221114,22140,288,16265770615,20220131,0,22140
20221115,22248,108,16361985925,20220131,0,22248
20221116,22857,609,16813593378,20220131,0,22857
20221117,22374,-483,16459220232,20220131,0,22374
20221118,22527,153,16597823602,20220131,0,22527
20221121,22190,-337,16359748194,20220131,0,22190
20221122,22030,-160,16241062805,20220131,0,22030
20221124,22327,297,16455405278,20220131,0,22327
20221125,22303,-24,16438954306,20220131,0,22303
20221128,21939,-364,16170381208,20220131,0,21939
20221129,21636,-303,15933136008,20220131,0,21636
20221130,21682,46,15975656282,20220131,0,21682
20221201,22974,1292,16920185672,20220131,0,22974
20221202,22849,-125,16823951376,20220131,0,22849
20221205,22904,55,16898277482,20220131,0,22904
20221206,22900,-4,16896018444,20220131,0,22900
20221207,22504,-396,16594233001,20220131,0,22504
20221208,22168,-336,16338110607,20220131,0,22168
20221209,22787,619,16798833141,20220131,0,22787
20221212,22718,-69,16710295732,20220131,0,22718
20221213,22862,144,16803014829,20220131,0,22862
20221214,22904,42,16840155605,20220131,0,22904
20221215,22722,-182,16703178824,20220131,0,22722
20221216,22034,-688,16174817525,20220131,0,22034
20221219,21616,-418,15883658433,20220131,0,21616
20221220,20919,-697,15370866884,20220131,0,20919
20221221,20435,-484,15012416259,20220131,0,20435
20221222,20968,533,15376768653,20220131,0,20968
20221223,20239,-729,14843127175,20220131,0,20239
20221226,20182,-57,14807193672,20220131,0,20182
20221227,20320,138,14894171404,20220131,0,20320
20221228,19798,-522,14511645324,20220131,0,19798
20221229,19638,-160,14406382106,20220131,0,19638
20221230,20164,526,14792729128,20220131,0,20164
20230104,19632,-532,14406304539,20220131,0,19632
20230105,19920,288,14620096901,20220131,0,19920
20230106,19661,-259,14461712268,20220131,0,19661
20230110,20378,717,14997070426,20220131,0,20378
20230111,20807,429,15314184980,20220131,0,20807
20230112,21169,362,15590648888,20220131,0,21169
20230113,20994,-175,15519361825,20220131,0,20994
20230116,20930,-64,15470493847,20220131,0,20930
20230117,21018,88,15535660560,20220131,0,21018
20230118,21639,621,15995230509,20220131,0,21639
20230119,20920,-719,15456251270,20220131,0,20920
20230120,20655,-265,15256965133,20220131,0,20655
20230123,21723,1068,16047642162,20220131,0,21723
20230124,22793,1070,16842342930,20220131,0,22793
20230125,22659,-134,16740774951,20220131,0,22659
20230126,22404,-255,16547843430,20220131,0,22404
20230127,23137,733,17098079732,20220131,0,23137
20230130,23846,709,17619522317,20230130,0,23846
20230131,23098,-748,17074812208,20230130,0,23098
20230201,23475,377,17346760807,20230130,0,23475
20230202,24195,720,17870255539,20230130,0,24195
20230203,25918,1723,19192490768,20230130,0,25918
20230206,25968,50,19221780708,20230130,0,25968
20230207,25745,-223,19023994828,20230130,0,25745
20230208,26050,305,19130616461,20230130,0,26050
20230209,25783,-267,18848642880,20230130,0,25783
20230210,25586,-197,18701316134,20230130,0,25586
20230213,24987,-599,18263847593,20230130,0,24987
20230214,25579,592,18674021898,20230130,0,25579
20230215,26262,683,19149806061,20230130,0,26262
20230216,26685,423,19446087339,20230130,0,26685
20230217,25776,-909,18760065871,20230130,0,25776
20230220,25473,-303,18534074033,20230130,0,25473
20230221,25448,-25,18471591627,20230130,0,25448
20230222,24882,-566,18060428721,20230130,0,24882
20230224,25267,385,18263637780,20230130,0,25267
20230227,25137,-130,18157969474,20230130,0,25137
20230228,25527,390,18439371188,20230130,0,25527
20230301,25565,38,18466331369,20230130,0,25565
20230302,25201,-364,18195690483,20230130,0,25201
20230303,25086,-115,18149074868,20230130,0,25086
20230306,25706,620,18586409078,20230130,0,25706
20230307,25667,-39,18566390906,20230130,0,25667
20230308,25682,15,18572059015,20230130,0,25682
20230309,25846,164,18674736090,20230130,0,25846
20230310,24975,-871,18038218040,20230130,0,24975
20230313,24280,-695,17486044221,20230130,0,24280
20230314,24323,43,17513533311,20230130,0,24323
20230315,25527,1204,18360938163,20230130,0,25527
20230316,25584,57,18393872337,20230130,0,25584
20230317,26565,981,19112993142,20230130,0,26565
20230320,26152,-413,18798893838,20230130,0,26152
20230322,26723,571,19200607278,20230130,0,26723
20230323,26020,-703,18628614508,20230130,0,26020
20230324,26622,602,19024503217,20230130,0,26622
20230327,26532,-90,18957471960,20230130,0,26532
20230328,26263,-269,18764140658,20230130,0,26263
20230329,26136,-127,18665332956,20230130,0,26136
20230330,26930,794,19229379835,20230130,0,26930
20230331,27507,577,19640536867,20230130,0,27507
20230403,28174,667,20111794136,20230130,0,28174
20230404,27824,-350,19837645143,20230130,0,27824
20230405,27648,-176,19674332604,20230130,0,27648
20230406,26940,-708,19080315521,20230130,0,26940
20230407,27300,360,19303549629,20230130,0,27300
20230410,27472,172,19391579923,20230130,0,27472
20230411,27688,216,19543619812,20230130,0,27688
20230412,27348,-340,19330047159,20230130,0,27348
20230413,26915,-433,19001914165,20230130,0,26915
20230414,27421,506,19329534949,20230130,0,27421
20230417,27659,238,19464089746,20230130,0,27659
20230418,27707,48,19490350407,20230130,0,27707
20230419,27639,-68,19435083743,20230130,0,27639
20230420,27701,62,19462630756,20230130,0,27701
20230421,27170,-531,19054989460,20230130,0,27170
20230424,27233,63,19097410781,20230130,0,27233
20230425,27128,-105,19015160451,20230130,0,27128
20230426,26305,-823,18423135842,20230130,0,26305
20230427,26807,502,18759782154,20230130,0,26807
20230428,27905,1098,19510796542,20230130,0,27905
20230501,28606,701,20009399980,20230130,0,28606
20230502,28729,123,20096693826,20230130,0,28729
20230508,28453,-276,19900076859,20230130,0,28453
20230509,28957,504,20194382297,20230130,0,28957
20230510,28855,-102,20130196784,20230130,0,28855
20230511,29198,343,20368485458,20230130,0,29198
20230512,29558,360,20641845922,20230130,0,29558
20230515,29557,-1,20632149170,20230130,0,29557
20230516,29775,218,20830633284,20230130,0,29775
20230517,30159,384,21117353173,20230130,0,30159
20230518,30967,808,21666443020,20230130,0,30967
20230519,32220,1253,22541163368,20230130,0,32220
20230522,31734,-486,22212303365,20230130,0,31734
20230523,32179,445,22506446401,20230130,0,32179
20230524,31796,-383,22223186975,20230130,0,31796
20230525,32093,297,22432768375,20230130,0,32093
20230526,32979,886,22975036422,20230130,0,32979
20230529,34257,1278,23878677745,20230130,0,34257
20230530,34135,-122,23861978944,20230130,0,34135
20230531,34537,402,24143616501,20230130,0,34537
20230601,34070,-467,24085672179,20230130,0,34070
20230602,34710,640,24537475878,20230130,0,34710
20230605,35245,535,25009471705,20230130,0,35245
20230606,35324,79,25161997674,20230130,0,35324
20230607,35496,172,25422204610,20230130,0,35496
20230608,34584,-912,24827742414,20230130,0,34584
20230609,35073,489,25254656797,20230130,0,35073
20230612,35457,384,25516359576,20230130,0,35457
20230613,36180,723,26146239529,20230130,0,36180
20230614,36599,419,26689669591,20230130,0,36599
20230615,37207,608,27271620510,20230130,0,37207
20230616,37593,386,27684566346,20230130,0,37593
20230619,37548,-45,27875067940,20230130,0,37548
20230620,37617,69,28112325507,20230130,0,37617
20230621,37643,26,28131772107,20230130,0,37643
20230622,36818,-825,27837651736,20230130,0,36818
20230623,37668,850,28829087339,20230130,0,37668
20230626,37489,-179,28761574157,20230130,0,37489
20230627,36407,-1082,27870879861,20230130,0,36407
20230628,37260,853,28498605844,20230130,0,37260
20230629,37721,461,28710876875,20230130,0,37721
20230630,37604,-117,28673525372,20230130,0,37604
20230703,38186,582,29306854238,20230130,0,38186
20230704,38492,306,29645488801,20230130,0,38492
20230705,38492,0,29920313286,20230130,0,38492
20230706,38538,46,29956151604,20230130,0,38538
20230707,38171,-367,30013217121,20230130,0,38171
20230710,37633,-538,29706132030,20230130,0,37633
20230711,37047,-586,29302040522,20230130,0,37047
20230712,36750,-297,29149965028,20230130,0,36750
20230713,37060,310,29412847931,20230130,0,37060
20230714,37883,823,30078354807,20230130,0,37883
20230718,38443,560,30674187421,20230130,0,38443
20230719,39009,566,31265365361,20230130,0,39009
20230720,39106,97,31627092785,20230130,0,39106
20230721,37412,-1694,30418224950,20230130,0,37412
20230724,37507,95,30570453165,20230130,0,37507
20230725,37577,70,30684214311,20230130,0,37577
20230726,37799,222,31034577690,20230130,0,37799
20230727,37353,-446,30717950849,20230130,0,37353
20230728,37046,-307,30593649094,20230130,0,37046
20230731,38489,1443,31900806454,20230130,0,38489
20230801,39058,569,32464253376,20230130,0,39058
20230802,39175,117,32645893260,20230130,0,39175
20230803,37887,-1288,31697153541,20230130,0,37887
20230804,37850,-37,31456670528,20230130,0,37850
20230807,37766,-84,31444765892,20230130,0,37766
20230808,38491,725,32152957741,20230130,0,38491
20230809,38008,-483,31833324581,20230130,0,38008
20230810,37334,-674,31288463071,20230130,0,37334
20230814,37263,-71,31216275930,20230130,0,37263
20230815,38035,772,31882350155,20230130,0,38035
20230816,37626,-409,31470949782,20230130,0,37626
20230817,37191,-435,31075859085,20230130,0,37191
20230818,36415,-776,30439752019,20230130,0,36415
20230821,36195,-220,30295721636,20230130,0,36195
20230822,37462,1267,31231443851,20230130,0,37462
20230823,37226,-236,31108801562,20230130,0,37226
20230824,37858,632,31682650574,20230130,0,37858
20230825,37051,-807,31043832595,20230130,0,37051
20230828,37466,415,31568424744,20230130,0,37466
20230829,37625,159,31764797170,20230130,0,37625
20230830,38665,1040,32718360927,20230130,0,38665
20230831,38932,267,32940103849,20230130,0,38932
20230901,38932,0,33082962919,20230130,0,38932
20230904,39010,78,33194749688,20230130,0,39010
20230905,39086,76,33395315892,20230130,0,39086
20230906,39874,788,34068105768,20230130,0,39874
20230907,39311,-563,33627504240,20230130,0,39311
20230908,38875,-436,33296603192,20230130,0,38875
20230911,38968,93,33366731823,20230130,0,38968
20230912,39704,736,34050567391,20230130,0,39704
20230913,39256,-448,33761249609,20230130,0,39256
20230914,39364,108,33927523842,20230130,0,39364
20230915,39578,214,34184574548,20230130,0,39578
20230919,38705,-873,33521005850,20230130,0,38705
20230920,38668,-37,33540983269,20230130,0,38668
20230921,38034,-634,33090797977,20230130,0,38034
20230922,36924,-1110,32206870429,20230130,0,36924
20230925,37116,192,32408341847,20230130,0,37116
20230926,37525,409,32723765488,20230130,0,37525
20230927,36886,-639,32208335480,20230130,0,36886
20230928,37034,148,32408279818,20230130,0,37034
20230929,37452,418,32852779885,20230130,0,37452
20231002,37616,164,33054774569,20230130,0,37616
20231003,38166,550,33631339639,20230130,0,38166
20231004,37250,-916,33069526997,20230130,0,37250
20231005,37822,572,33639372607,20230130,0,37822
20231006,37737,-85,33582397170,20230130,0,37737
20231010,38845,1108,34647466038,20230130,0,38845
20231011,38924,79,34737406965,20230130,0,38924
20231012,39467,543,35378409685,20230130,0,39467
20231013,39535,68,35502894351,20230130,0,39535
20231016,38650,-885,34811982548,20230130,0,38650
20231017,39270,620,35410551693,20230130,0,39270
20231018,38943,-327,35117742576,20230130,0,38943
20231019,38101,-842,34416038228,20230130,0,38101
20231020,38186,85,34590968945,20230130,0,38186
20231023,37451,-735,33985558309,20230130,0,37451
20231024,37845,394,34407896482,20230130,0,37845
20231025,38372,527,34935197150,20230130,0,38372
20231026,37149,-1223,33918202530,20230130,0,37149
20231027,36184,-965,33137751963,20230130,0,36184
20231030,36539,355,33521544345,20230130,0,36539
20231031,36931,392,33999973318,20230130,0,36931
20231101,37474,543,34638758125,20230130,0,37474
20231102,38071,597,35291723351,20230130,0,38071
20231106,38966,895,36298397051,20230130,0,38966
20231107,39191,225,36713030769,20230130,0,39191
20231108,40101,910,37848188972,20230130,0,40101
20231109,40398,297,38109712748,20230130,0,40398
20231110,40156,-242,37925224683,20230130,0,40156
20231113,41321,1165,38988998745,20230130,0,41321
20231114,41270,-51,38943285366,20230130,0,41270
20231115,41927,657,39654586715,20230130,0,41927
20231116,42124,197,39972255877,20230130,0,42124
20231117,41995,-129,40298439119,20230130,0,41995
20231120,41810,-185,40304909015,20230130,0,41810
20231121,41958,148,40790713410,20230130,0,41958
20231122,41834,-124,40953875692,20230130,0,41834
20231124,42275,441,41536224828,20230130,0,42275
20231127,42147,-128,41579702886,20230130,0,42147
20231128,41637,-510,41288049323,20230130,0,41637
20231129,41543,-94,41612961003,20230130,0,41543
20231130,41379,-164,41527948181,20230130,0,41379
20231201,41493,114,41767099543,20230130,0,41493
20231204,40912,-581,41323664326,20230130,0,40912
20231205,40583,-329,41287857986,20230130,0,40583
20231206,40871,288,41650518275,20230130,0,40871
20231207,40432,-439,41206803376,20230130,0,40432
20231208,40125,-307,40952823611,20230130,0,40125
20231211,41121,996,42008527590,20230130,0,41121
20231212,41345,224,42335746877,20230130,0,41345
20231213,41760,415,43060103105,20230130,0,41760
20231214,41344,-416,42764320621,20230130,0,41344
20231215,41445,101,43011715672,20230130,0,41445
20231218,41664,219,43403901575,20230130,0,41664
20231219,42390,726,44280506391,20230130,0,42390
20231220,43023,633,45049227471,20230130,0,43023
20231221,42212,-811,44212578373,20230130,0,42212
20231222,42415,203,45226595667,20230130,0,42415
20231225,42246,-169,45168599847,20230130,0,42246
20231226,42259,13,45437316808,20230130,0,42259
20231227,42667,408,45875511121,20230130,0,42667
20231228,42457,-210,46646239456,20230130,0,42457
20231229,42372,-85,46912502548,20230130,0,42372
20240104,41046,-1326,45844530845,20230130,0,41046
20240105,41284,238,46598829284,20230130,0,41284
20240109,42345,1061,52296649246,20230130,0,42345
20240110,42669,324,53763741829,20230130,0,42669
20240111,43381,712,56609747811,20230130,0,43381
20240112,43398,17,57805626475,20230130,0,43398
20240115,43243,-155,58783902698,20230130,0,43243
20240116,43458,215,60017859935,20230130,0,43458
20240117,43779,321,60460609550,20230130,0,43779
20240118,43769,-10,62900639183,20230130,0,43769
20240119,44335,566,64469956520,20230130,0,44335
20240122,45301,966,66666546077,20230130,0,45301
20240123,45407,106,67605496452,20230130,0,45407
20240124,45829,422,70790083204,20230130,0,45829
20240125,46551,722,73418717556,20230130,0,46551
20240126,46359,-192,74692543633,20230130,0,46359
20240129,46400,41,76289289922,20230130,0,46400
20240130,46887,487,78565798204,20240130,0,46887
20240131,46520,-367,80109430874,20240130,0,46520
20240201,44978,-1542,78639408341,20240130,0,44978
20240202,45561,583,80893675100,20240130,0,45561
20240205,48507,2946,88924155152,20240130,0,48507
20240206,48400,-107,90289468816,20240130,0,48400
20240207,47889,-511,91433537791,20240130,0,47889
20240208,48829,940,94420413456,20240130,0,48829
20240209,49418,589,96954763213,20240130,0,49418
20240213,49836,418,99899654209,20240130,0,49836
20240214,49544,-292,1.00798E+11,20240130,0,49544
20240215,50473,929,1.07574E+11,20240130,0,50473
20240216,50506,33,1.09505E+11,20240130,0,50506
20240219,49922,-584,1.10451E+11,20240130,0,49922
20240220,50039,117,1.12778E+11,20240130,0,50039
20240221,49079,-960,1.10614E+11,20240130,0,49079
20240222,49007,-72,1.15012E+11,20240130,0,49007
20240226,51116,2109,1.21365E+11,20240130,0,51116
20240227,51185,69,1.23781E+11,20240130,0,51185
20240228,51356,171,1.27402E+11,20240130,0,51356
20240229,51039,-317,1.27841E+11,20240130,0,51039
20240301,50531,-508,1.27886E+11,20240130,0,50531
20240304,51413,882,1.31994E+11,20240130,0,51413
20240305,51014,-399,1.34274E+11,20240130,0,51014
20240306,49724,-1290,1.34183E+11,20240130,0,49724
20240307,49546,-178,1.35217E+11,20240130,0,49546
20240308,50375,829,1.38353E+11,20240130,0,50375
20240311,48877,-1498,1.35005E+11,20240130,0,48877
20240312,48391,-486,1.34655E+11,20240130,0,48391
20240313,49674,1283,1.38983E+11,20240130,0,49674
20240314,49341,-333,1.38558E+11,20240130,0,49341
20240315,49513,172,1.39503E+11,20240130,0,49513
20240318,49137,-376,1.38678E+11,20240130,0,49137
20240319,49955,818,1.41305E+11,20240130,0,49955
20240321,51549,1594,1.46265E+11,20240130,0,51549
20240322,51716,167,1.47073E+11,20240130,0,51716
20240325,52015,299,1.48612E+11,20240130,0,52015
20240326,51851,-164,1.48385E+11,20240130,0,51851
20240327,51738,-113,1.4923E+11,20240130,0,51738
20240328,51668,-70,1.49736E+11,20240130,0,51668
20240329,51414,-254,1.49784E+11,20240130,0,51414
20240401,51418,4,1.50368E+11,20240130,0,51418
20240402,51879,461,1.51716E+11,20240130,0,51879
20240403,51276,-603,1.52373E+11,20240130,0,51276
20240404,51654,378,1.54389E+11,20240130,0,51654
20240405,50727,-927,1.51989E+11,20240130,0,50727
20240408,51753,1026,1.55468E+11,20240130,0,51753
20240409,51920,167,1.56463E+11,20240130,0,51920
20240410,51918,-2,1.57532E+11,20240130,0,51918
20240411,52069,151,1.58364E+11,20240130,0,52069
20240412,53428,1359,1.62944E+11,20240130,0,53428
20240415,52785,-643,1.61359E+11,20240130,0,52785
20240416,51706,-1079,1.58344E+11,20240130,0,51706
20240417,51765,59,1.59446E+11,20240130,0,51765
20240418,50990,-775,1.57697E+11,20240130,0,50990
20240419,50735,-255,1.57387E+11,20240130,0,50735
20240422,48842,-1893,1.51896E+11,20240130,0,48842
20240423,49237,395,1.53001E+11,20240130,0,49237
20240424,50313,1076,1.56204E+11,20240130,0,50313
20240425,50870,557,1.58645E+11,20240130,0,50870
20240426,50669,-201,1.59111E+11,20240130,0,50669
20240430,53018,2349,1.67087E+11,20240130,0,53018
20240501,52068,-950,1.64376E+11,20240130,0,52068
20240502,51262,-806,1.62713E+11,20240130,0,51262
20240507,53457,2195,1.72245E+11,20240130,0,53457
20240508,53461,4,1.72997E+11,20240130,0,53461
20240509,53652,191,1.75124E+11,20240130,0,53652
20240510,53543,-109,1.75723E+11,20240130,0,53543
20240513,53629,86,1.76433E+11,20240130,0,53629
20240514,54036,407,1.78187E+11,20240130,0,54036
20240515,54684,648,1.8109E+11,20240130,0,54684
20240516,54496,-188,1.80813E+11,20240130,0,54496
20240517,54865,369,1.82852E+11,20240130,0,54865
20240520,54948,83,1.84146E+11,20240130,0,54948
20240521,55611,663,1.87088E+11,20240130,0,55611
20240522,55969,358,1.89919E+11,20240130,0,55969
20240523,55800,-169,1.90198E+11,20240130,0,55800
20240524,55524,-276,1.90338E+11,20240130,0,55524
20240527,56258,734,1.93836E+11,20240130,0,56258
20240528,56281,23,1.9481E+11,20240130,0,56281
20240529,56775,494,1.96519E+11,20240130,0,56775
20240530,56677,-98,1.98174E+11,20240130,0,56677
20240531,55340,-1337,1.943E+11,20240130,0,55340
20240603,55024,-316,1.94035E+11,20240130,0,55024
20240604,55187,163,1.95602E+11,20240130,0,55187
20240605,54913,-274,1.98665E+11,20240130,0,54913
20240606,56299,1386,2.045E+11,20240130,0,56299
20240607,56289,-10,2.05293E+11,20240130,0,56289
20240610,56584,295,2.06686E+11,20240130,0,56584
20240611,56806,222,2.07777E+11,20240130,0,56806
20240612,57396,590,2.11584E+11,20240130,0,57396
20240613,58282,886,2.1533E+11,20240130,0,58282
20240614,59304,1022,2.19749E+11,20240130,0,59304
20240617,59807,503,2.22345E+11,20240130,0,59807
20240618,60944,1137,2.27607E+11,20240130,0,60944
20240619,60796,-148,2.27832E+11,20240130,0,60796
20240620,60872,76,2.29458E+11,20240130,0,60872
20240621,60487,-385,2.28005E+11,20240130,0,60487
20240624,60473,-14,2.30558E+11,20240130,0,60473
20240625,59363,-1110,2.27272E+11,20240130,0,59363
20240626,60331,968,2.31899E+11,20240130,0,60331
20240627,61752,1421,2.38048E+11,20240130,0,61752
20240628,62366,614,2.4148E+11,20240130,0,62366
20240701,61815,-551,2.40182E+11,20240130,0,61815
20240702,63401,1586,2.4771E+11,20240130,0,63401
20240703,64431,1030,2.56878E+11,20240130,0,64431
20240704,65462,1031,2.62876E+11,20240130,0,65462
20240705,65339,-123,2.64752E+11,20240130,0,65339
20240708,66061,722,2.67682E+11,20240130,0,66061
20240709,66147,86,2.72998E+11,20240130,0,66147
20240710,66543,396,2.7914E+11,20240130,0,66543
20240711,67148,605,2.84649E+11,20240130,0,67148
20240712,63739,-3409,2.72663E+11,20240130,0,63739
20240716,63677,-62,2.74771E+11,20240130,0,63677
20240717,63594,-83,2.76684E+11,20240130,0,63594
20240718,60472,-3122,2.66481E+11,20240130,0,60472
20240719,60868,396,2.6882E+11,20240130,0,60868
20240722,60173,-695,2.64887E+11,20240130,0,60173
20240723,61137,964,2.69376E+11,20240130,0,61137
20240724,60903,-234,2.6905E+11,20240130,0,60903
20240725,56620,-4283,2.50841E+11,20240130,0,56620
20240726,56578,-42,2.50985E+11,20240130,0,56578
20240729,56807,229,2.50493E+11,20240130,0,56807
20240730,57330,523,2.52889E+11,20240130,0,57330
20240731,55710,-1620,2.46498E+11,20240130,0,55710
20240801,56561,851,2.50758E+11,20240130,0,56561
20240802,55005,-1556,2.44111E+11,20240130,0,55005
20240805,51975,-3030,2.33231E+11,20240130,0,51975
20240806,49755,-2220,2.22374E+11,20240130,0,49755
20240807,51123,1368,2.22565E+11,20240130,0,51123
20240808,50171,-952,2.17745E+11,20240130,0,50171
20240809,52456,2285,2.28459E+11,20240130,0,52456
20240813,52918,462,2.32004E+11,20240130,0,52918
20240814,54484,1566,2.39823E+11,20240130,0,54484
20240815,54537,53,2.41909E+11,20240130,0,54537
20240816,56571,2034,2.52381E+11,20240130,0,56571
20240819,56293,-278,2.52923E+11,20240130,0,56293
20240820,56691,398,2.56076E+11,20240130,0,56691
20240821,56313,-378,2.55917E+11,20240130,0,56313
20240822,56548,235,2.57489E+11,20240130,0,56548
20240823,54878,-1670,2.50119E+11,20240130,0,54878
20240826,54624,-254,2.49013E+11,20240130,0,54624
20240827,54546,-78,2.48832E+11,20240130,0,54546
20240828,54169,-377,2.47464E+11,20240130,0,54169
20240829,53453,-716,2.44352E+11,20240130,0,53453
20240830,53522,69,2.44709E+11,20240130,0,53522
20240902,54929,1407,2.51091E+11,20240130,0,54929
20240903,55274,345,2.52658E+11,20240130,0,55274
20240904,52728,-2546,2.41021E+11,20240130,0,52728
20240905,52268,-460,2.42077E+11,20240130,0,52268
20240906,52696,428,2.43847E+11,20240130,0,52696
20240909,50321,-2375,2.33079E+11,20240130,0,50321
20240910,51307,986,2.3772E+11,20240130,0,51307
20240911,51587,280,2.40205E+11,20240130,0,51587
20240912,53183,1596,2.47945E+11,20240130,0,53183
20240913,53486,303,2.49548E+11,20240130,0,53486
20240917,53082,-404,2.47931E+11,20240130,0,53082
20240918,53558,476,2.50362E+11,20240130,0,53558
20240919,54082,524,2.53338E+11,20240130,0,54082
20240920,55511,1429,2.60227E+11,20240130,0,55511
20240924,55978,467,2.62553E+11,20240130,0,55978
20240925,56100,122,2.63764E+11,20240130,0,56100
20240926,56489,389,2.66053E+11,20240130,0,56489
20240927,56765,276,2.67702E+11,20240130,0,56765
20240930,55306,-1459,2.61033E+11,20240130,0,55306
20241001,56040,734,2.64964E+11,20240130,0,56040
20241002,55056,-984,2.60551E+11,20240130,0,55056
20241003,56580,1524,2.7022E+11,20240130,0,56580
20241004,56749,169,2.71419E+11,20240130,0,56749
20241007,58472,1723,2.80287E+11,20240130,0,58472
20241008,57365,-1107,2.75105E+11,20240130,0,57365
20241009,58694,1329,2.81683E+11,20240130,0,58694
20241010,59674,980,2.87549E+11,20240130,0,59674
20241011,59810,136,2.88559E+11,20240130,0,59810
20241015,60338,528,2.91369E+11,20240130,0,60338
20241016,59349,-989,2.86859E+11,20240130,0,59349
20241017,59491,142,2.88539E+11,20240130,0,59491
20241018,59826,335,2.90508E+11,20240130,0,59826
20241021,60329,503,2.93297E+11,20240130,0,60329
20241022,61233,904,2.98041E+11,20240130,0,61233
20241023,61600,367,3.0038E+11,20240130,0,61600
20241024,60774,-826,2.96491E+11,20240130,0,60774
20241025,61039,265,2.97946E+11,20240130,0,61039
20241028,61814,775,3.01471E+11,20240130,0,61814
20241029,61603,-211,3.0086E+11,20240130,0,61603
20241030,62813,1210,3.07611E+11,20240130,0,62813
20241031,62744,-69,3.0803E+11,20240130,0,62744
20241101,60182,-2562,2.96133E+11,20240130,0,60182
20241105,60701,519,2.99214E+11,20240130,0,60701
20241106,61952,1251,3.08514E+11,20240130,0,61952
20241107,64296,2344,3.22798E+11,20240130,0,64296
20241108,65135,839,3.27702E+11,20240130,0,65135
20241111,64773,-362,3.26919E+11,20240130,0,64773
20241112,65126,353,3.30405E+11,20240130,0,65126
20241113,66093,967,3.36598E+11,20240130,0,66093
20241114,66472,379,3.39119E+11,20240130,0,66472
20241115,66649,177,3.40445E+11,20240130,0,66649
20241118,63807,-2842,3.26555E+11,20240130,0,63807
20241119,64249,442,3.30196E+11,20240130,0,64249
20241120,65602,1353,3.38464E+11,20240130,0,65602
20241121,65505,-97,3.39158E+11,20240130,0,65505
20241122,65238,-267,3.38812E+11,20240130,0,65238
20241125,65202,-36,3.39171E+11,20240130,0,65202
20241126,64816,-386,3.37527E+11,20240130,0,64816
20241127,64986,170,3.39338E+11,20240130,0,64986
20241128,63566,-1420,3.32326E+11,20240130,0,63566
20241129,63134,-432,3.3033E+11,20240130,0,63134
20241202,63416,282,3.31807E+11,20240130,0,63416
20241203,64103,687,3.36657E+11,20240130,0,64103
20241204,64710,607,3.42931E+11,20240130,0,64710
20241205,66405,1695,3.53489E+11,20240130,0,66405
20241206,66358,-47,3.53537E+11,20240130,0,66358
20241209,67032,674,3.58029E+11,20240130,0,67032
20241210,67159,127,3.59298E+11,20240130,0,67159
20241211,67127,-32,3.61668E+11,20240130,0,67127
20241212,69348,2221,3.74431E+11,20240130,0,69348
20241213,69278,-70,3.75021E+11,20240130,0,69278
20241216,70651,1373,3.83448E+11,20240130,0,70651
